00000000000000000000000000000000000000000
00000000000000000000000000000000000000000
00000000000000011111110000000000000000000
00000000000000010040010000000000000000000
00000000000000010444010000000000000000000
00000000111111110000011111111100000000000
00000000100000000000000000000100000000000
00000000100011111111000000000100000000000
00000000200010000001111111111100000000000
00000000000010000000000000000000000000000
00000000000010044400111111100000000000000
00000000000010044400144400100000000000000
00000000000010000000144000100000000000000
00000000000031111111140000111100000000000
00000000000000000000000000000100000000000
00000000000000000000000011111100000000000
00000000000000000000000010000000000000000
00000000000000000000004410000000000000000
00000000000021111111111110000000000000000
00000000000000000000000000000000000000000
00000000000000000000000000000000000000000
00000000000000000000000000000000000000000
00000000000000000000000000000000000000000
00000000000000000000000000000000000000000
00000000000000000000000000000000000000000
00000000000000000000000000000000000000000
