444444444444444444444444444444444444444
444444400044004444444444444444444444440
000000000000000000000000000000000000000
000000000000000000000000000000000000000
000000000000000000000000000000440000000
000000000000004440000000000111110000000
000000002111111111111100000100010000000
000000000000000000000111111100010000000
000000000000000000000000000000010000000
000000000000000000000000000000010000000
000000000000000111111111111111110000000
000000040044000100000000000000000000000
000000040044000311110000000000000000000
000000044000000000011111111100044000000
000000000000000000000000000100004400000
000000000000001111111111111100004400000
000000000004401000000000000000000000000
000000000000001111111000000000000000000
000000000000000000001440000000000000000
000000000000000000001000000000000000000
000000000000000000002000000000000000000
000000000000000000000000000000000000000
444440004440004444400000444444444000444
444000044440000000004400000044444444444
444444400000400000404444444444444444444
444444444444444444000004444444444444444
444444444444444444444444444444444444444
444444444444444444444444444444444444444
