0000000000000000000000000000000000
0000000000000000000000000000000000
0000000000000111110000000000000000
0000000000000100010044400000000000
0000000000000100010000000000000000
0000000000000100010000000000000000
0000211111100100010000000111110000
0000000000100100010000000100010000
0000000000100100010000000100010000
0000400000111100010000001100010000
0000400000000000010000001000010000
0000400000000000011111111000110000
0000400000000000000000000000100000
0000000000000000000000000000100400
0000000000011111131000000000100000
0000000000010000001110111111100000
0000000111110000000014100000000000
0000000100000440000011100000000000
0000111100000000000000000040000000
0000100000000000000111110040002000
0000100000000000000100010040001000
0000111111111111100100010000011000
0000000000000000100100010000010000
0000000000400000100100011111110000
0000000000000000111100000000000000
0000000000000000000004444440000000
0000000000000000000000000000000000
0000000000000000000000000000000000
