444444444444444444444444444444444444444
444444400044004444444444444444444444440
000004000004400000000000044440000000000
000000000000011111110000000044000000000
000000000000010040010000000000000000000
000000000000010444011111111000000000000
000000211111110000000000001100000000000
000000000000000000000000000100000000000
000000444011111111111111111100000000000
000000400010000000000000000000000000000
000000000010000000000000000000000000000
000000000010044400000000000000000000000
000000000011111131111111100000000000000
000000000000000010044000100000000000000
000000000444044410040000111100000000000
000000000004400010000000000100000000000
000000011111111110000000000111111004400
000000010000000000000000000000001004400
000000010000000000000441111111141004400
000000010044421111111111000000111004400
000000011112444000000000000000000000000
000000000000000000000000000000000000000
444440004440004444400000444444444000444
444000044440000000004400000044444444444
444444400000400000404444444444444444444
444444444444444444000004444444444444444
444444444444444444444444444444444444444
444444444444444444444444444444444444444
